1,1,1,1,1,1,1,1,1,1,1,1,1,1,1
1,0,0,0,0,0,0,0,0,0,0,0,0,0,1
1,0,67,67,67,0,67,67,67,67,67,67,67,0,1
1,0,67,67,67,0,67,67,67,67,67,67,67,0,1
1,0,67,67,67,0,67,0,0,0,0,0,67,0,1
1,0,0,67,0,0,67,67,67,67,67,0,0,0,1
1,0,0,67,0,0,0,0,0,0,67,0,0,0,1
1,0,0,67,0,0,0,0,0,0,67,1,1,1,1
1,0,67,67,67,67,67,67,0,67,67,67,67,1,1
1,0,67,67,67,67,67,67,67,67,67,67,67,1,1
1,0,67,67,67,67,67,67,0,67,67,67,67,1,1
1,0,0,0,0,0,0,0,0,0,0,0,1,1,1
1,1,1,1,1,1,100,1,1,1,1,1,1,1,1
1,1,1,1,1,1,66,1,1,1,1,1,1,1,1