1,1,1,1,1,1,1,1,1,1,1,1,1,1,1
1,1,1,1,1,1,1,1,1,1,1,1,1,1,1
1,1,0,0,0,1,0,0,0,0,0,0,0,1,1
1,1,0,0,0,1,0,0,0,0,0,0,0,1,1
1,1,0,0,0,1,0,1,1,1,1,1,0,1,1
1,1,1,0,1,1,0,0,0,0,0,1,2,1,1
1,1,1,100,1,1,1,1,1,1,100,1,1,1,1
1,1,1,0,1,1,1,1,1,1,0,1,1,1,1
1,1,0,0,0,0,0,0,1,0,0,0,1,1,1
1,1,0,0,0,0,0,0,0,0,0,0,1,1,1
1,1,0,0,0,0,0,0,1,0,0,0,1,1,1
1,1,1,1,1,1,1,1,1,1,1,1,1,1,1
1,1,1,1,1,1,66,1,1,1,1,1,1,1,1