1,1,3,1,1,1,1,3,3,1,3,1,1
1,0,0,0,1,0,0,0,0,0,0,0,3
3,0,0,0,1,0,0,0,0,0,0,0,1
1,0,0,0,3,0,1,1,1,1,1,0,3
3,1,0,1,1,0,0,0,0,0,0,0,1
1,3,100,1,1,3,3,3,1,100,1,1,1
15,15,0,15,15,9,15,15,15,0,15,15,15
15,0,0,0,0,0,0,15,0,0,0,0,15
9,0,0,0,0,0,0,0,0,0,0,0,15
15,0,0,0,0,0,0,15,0,0,0,0,15
15,15,9,15,15,9,15,15,15,15,15,15,15